"filename", "language", "TypeScript", "JSON", "Properties", "JavaScript", "JSON with Comments", "comment", "blank", "total"
"/Users/prafullprince/Desktop/rentabuddy/server/.env", "Properties", 0, 0, 8, 0, 0, 0, 6, 14
"/Users/prafullprince/Desktop/rentabuddy/server/dist/index.js", "JavaScript", 0, 0, 0, 25, 0, 1, 1, 27
"/Users/prafullprince/Desktop/rentabuddy/server/package-lock.json", "JSON", 0, 2469, 0, 0, 0, 0, 1, 2470
"/Users/prafullprince/Desktop/rentabuddy/server/package.json", "JSON", 0, 48, 0, 0, 0, 0, 1, 49
"/Users/prafullprince/Desktop/rentabuddy/server/src/config/cloudinary.ts", "TypeScript", 14, 0, 0, 0, 0, 1, 2, 17
"/Users/prafullprince/Desktop/rentabuddy/server/src/config/mongodb.ts", "TypeScript", 13, 0, 0, 0, 0, 1, 4, 18
"/Users/prafullprince/Desktop/rentabuddy/server/src/config/razorpay.ts", "TypeScript", 7, 0, 0, 0, 0, 0, 2, 9
"/Users/prafullprince/Desktop/rentabuddy/server/src/config/redis.ts", "TypeScript", 13, 0, 0, 0, 0, 0, 6, 19
"/Users/prafullprince/Desktop/rentabuddy/server/src/controllers/auth.controllers.ts", "TypeScript", 77, 0, 0, 0, 0, 15, 20, 112
"/Users/prafullprince/Desktop/rentabuddy/server/src/controllers/category.controllers.ts", "TypeScript", 147, 0, 0, 0, 0, 42, 43, 232
"/Users/prafullprince/Desktop/rentabuddy/server/src/controllers/event.controllers.ts", "TypeScript", 355, 0, 0, 0, 0, 76, 72, 503
"/Users/prafullprince/Desktop/rentabuddy/server/src/controllers/payment.controllers.ts", "TypeScript", 125, 0, 0, 0, 0, 66, 51, 242
"/Users/prafullprince/Desktop/rentabuddy/server/src/controllers/post.controllers.ts", "TypeScript", 98, 0, 0, 0, 0, 16, 25, 139
"/Users/prafullprince/Desktop/rentabuddy/server/src/helper/apiResponse.helper.ts", "TypeScript", 14, 0, 0, 0, 0, 0, 3, 17
"/Users/prafullprince/Desktop/rentabuddy/server/src/helper/mediaUpload.helper.ts", "TypeScript", 15, 0, 0, 0, 0, 0, 9, 24
"/Users/prafullprince/Desktop/rentabuddy/server/src/index.ts", "TypeScript", 38, 0, 0, 0, 0, 7, 10, 55
"/Users/prafullprince/Desktop/rentabuddy/server/src/middleware/auth.middleware.ts", "TypeScript", 71, 0, 0, 0, 0, 20, 26, 117
"/Users/prafullprince/Desktop/rentabuddy/server/src/models/category.models.ts", "TypeScript", 14, 0, 0, 0, 0, 0, 4, 18
"/Users/prafullprince/Desktop/rentabuddy/server/src/models/event.models.ts", "TypeScript", 31, 0, 0, 0, 0, 0, 4, 35
"/Users/prafullprince/Desktop/rentabuddy/server/src/models/post.models.ts", "TypeScript", 12, 0, 0, 0, 0, 3, 6, 21
"/Users/prafullprince/Desktop/rentabuddy/server/src/models/rating.models.ts", "TypeScript", 18, 0, 0, 0, 0, 0, 5, 23
"/Users/prafullprince/Desktop/rentabuddy/server/src/models/section.models.ts", "TypeScript", 18, 0, 0, 0, 0, 0, 4, 22
"/Users/prafullprince/Desktop/rentabuddy/server/src/models/subcategory.models.ts", "TypeScript", 26, 0, 0, 0, 0, 0, 4, 30
"/Users/prafullprince/Desktop/rentabuddy/server/src/models/subsection.models.ts", "TypeScript", 22, 0, 0, 0, 0, 0, 5, 27
"/Users/prafullprince/Desktop/rentabuddy/server/src/models/transaction.models.ts", "TypeScript", 24, 0, 0, 0, 0, 0, 4, 28
"/Users/prafullprince/Desktop/rentabuddy/server/src/models/user.models.ts", "TypeScript", 103, 0, 0, 0, 0, 3, 6, 112
"/Users/prafullprince/Desktop/rentabuddy/server/src/models/wallet.models.ts", "TypeScript", 29, 0, 0, 0, 0, 11, 30, 70
"/Users/prafullprince/Desktop/rentabuddy/server/src/routes/auth.routes.ts", "TypeScript", 7, 0, 0, 0, 0, 5, 5, 17
"/Users/prafullprince/Desktop/rentabuddy/server/src/routes/category.routes.ts", "TypeScript", 3, 0, 0, 0, 0, 5, 7, 15
"/Users/prafullprince/Desktop/rentabuddy/server/src/routes/event.routes.ts", "TypeScript", 3, 0, 0, 0, 0, 5, 7, 15
"/Users/prafullprince/Desktop/rentabuddy/server/src/routes/interaction.routes.ts", "TypeScript", 3, 0, 0, 0, 0, 5, 7, 15
"/Users/prafullprince/Desktop/rentabuddy/server/src/routes/payment.routes.ts", "TypeScript", 3, 0, 0, 0, 0, 5, 7, 15
"/Users/prafullprince/Desktop/rentabuddy/server/src/routes/post.routes.ts", "TypeScript", 3, 0, 0, 0, 0, 5, 7, 15
"/Users/prafullprince/Desktop/rentabuddy/server/src/routes/user.routes.ts", "TypeScript", 3, 0, 0, 0, 0, 5, 7, 15
"/Users/prafullprince/Desktop/rentabuddy/server/src/types/global/express.d.ts", "TypeScript", 13, 0, 0, 0, 0, 0, 3, 16
"/Users/prafullprince/Desktop/rentabuddy/server/src/types/schema/categorySchema.types.ts", "TypeScript", 12, 0, 0, 0, 0, 0, 4, 16
"/Users/prafullprince/Desktop/rentabuddy/server/src/types/schema/eventSchema.types.ts", "TypeScript", 18, 0, 0, 0, 0, 0, 6, 24
"/Users/prafullprince/Desktop/rentabuddy/server/src/types/schema/postSchema.types.ts", "TypeScript", 5, 0, 0, 0, 0, 0, 2, 7
"/Users/prafullprince/Desktop/rentabuddy/server/src/types/schema/ratingSchema.types.ts", "TypeScript", 5, 0, 0, 0, 0, 0, 1, 6
"/Users/prafullprince/Desktop/rentabuddy/server/src/types/schema/userSchema.types.ts", "TypeScript", 26, 0, 0, 0, 0, 0, 2, 28
"/Users/prafullprince/Desktop/rentabuddy/server/src/types/schema/walletSchema.types.ts", "TypeScript", 8, 0, 0, 0, 0, 0, 2, 10
"/Users/prafullprince/Desktop/rentabuddy/server/src/zod/request.body.validation.ts", "TypeScript", 1, 0, 0, 0, 0, 0, 2, 3
"/Users/prafullprince/Desktop/rentabuddy/server/tsconfig.json", "JSON with Comments", 0, 0, 0, 0, 14, 0, 1, 15
"Total", "-", 1397, 2517, 8, 25, 14, 297, 424, 4682